asociación en participación|asociacion en participacion|a en p
asociación civil|asociacion civil|ac|a c
banco|bco|b.co
club atlético|club atletico
club de fútbol|club de futbol|cf|c f|c.f.|c.f
compañía|compania|cía|cia|c.ía|c.ia|ca|c.a|comp
compañía anónima|compania anonima|ca|c a
compañía por acciónes|compania por acciones|c por a|cxa|c x a
empresa|empr|emp
empresa individual de responsabilidad limitada|eirl|e i r l
empresa publica|ep|e.p.|e.p|e p
empresa unipersonal|e.u.|e.u|e u
fútbol club|futbol club|fc|f.c.|f.c|f c|football club
sociedad|sdad|s.dad|soc
sociedad anónima|sociedad anonima|sa|s.a.|s.a|s a|sdad anon
sociedad anónima abierta|sociedad anonima abierta|saa|s.a.a.|s.a.a|s a a
sociedad anónima bursatil|sociedad anonima bursatil|sab|s.a.b.|s.a.b|s a b
sociedad anónima deportiva|sociedad anonima deportiva|sad|s.a.d.|s.a.d|s a d
sociedad anónima de capital variable|sociedad anonima de capital variable|sa de cv|s a de c v
sociedad anónima cooperativa catalana limitada|sociedad anonima cooperativa catalana limitada|sccl|s.c.c.l.|s.c.c.l|s c c l
sociedad anónima española|sociedad anonima espanola|sae|s.a.e.|s.a.e|s a e
sociedad anónima finciera de inversión|sociedad anonima financiera de inversion|safi|s.a.f.i.|s.a.f.i|s a f i
sociedad anónima inscrita de capital abierto|sociedad anonima inscrita de capital abierto|saica|s.a.i.c.a.|s.a.i.c.a|s a i c a
sociedad anónima laboral|sociedad anonima laboral|sal|s.a.l.|s.a.l|s a l
sociedad anónima promotora de inversión|sociedad anonima promotora de inversion|sapi|s.a.p.i.|s.a.p.i|s a p i
sociedad anónima simplificada|sociedad anonima simplificada|sas|s.a.s.|s.a.s|s a s
sociedad civil|sc|s.c.|s.c|s c
sociedad colectiva|snc|s n c|soc cal|y cia sc|y cia s c|& cia sc|& cia s c
sociedad comanditaria|scra|s cra
sociedad cooperativa|scoop|s coop
sociedad cooperativa limitada|scl|s.c.l.|s.c.l|s c l
sociedad de capital e industria|scel|s.c.e.l.|s.c.e.l|s c e l
sociedad de garantia reciproca|sgr|s.g.r.|s.g.r|s g r
sociedad de responsabilidad limitada|srl|s.r.l.|s.r.l|s r l|s de rl|s de r l
sociedad del estado|se|s.e.|s.e|s e
sociedad en comandita|s en c|sc|y cia s en c|& cia s en c
sociedad en comandita port acciónes|sociedad en comandita por acciones|s en c por a|sca|s c a|cia sca|cia s c a
sociedad en nombre colectivo|cia|s en nc|s en n c
sociedad en nombre colectivo de responsabilidad limitada|cia ltda|ltda
sociedad gestora de instituciones de inversión colectiva|sociedad gestora de instituciones de inversion colectiva|sgiic|s g i i c
sociedad limitada|sl|s l|s.l.|s.l|sdad ltda
sociedad limitada laboral|sll|s.l.l.|s.l.l|s l l
sociedad limitada nueva empresa|slne|s.l.n.e.|s.l.n.e|s l n e
sociedad limitada unipersonal|slu|s.l.u.|s.l.u|s l u
sociedad port acciónes|sociedad por acciones|spa|s.p.a.|s.p.a|s p a
unión deportiva|union deportiva|ud|u.d.|u.d|u d
unión|union
y compañía|y compania|& compania|& compañía|y cía|y cia|& cía|& cia
y sucesores|& sucesores