nord|n
norden
nördlich|nördl|nordl|nordlich|noerdlich
nördliche|nordliche|noerdliche
nördlicher|nordlicher|noerdlicher
nördliches|nordliches|noerdliches
nordost|no
nordosten
nordöstlich|nordostlich|nordoestlich
nordwest|nw
nordwestliche
ost|o
osten
östlich|östl|ostlich|ostl|oestlich
östliche|ostliche|oestliche
östlicher|ostlicher|oestlicher
östliches|ostliches|oestliches
süd|s|sud|sued
süden|suden|sueden
südlich|südl|sudl|sudlich|suedlich
südliche|sudliche|suedliche
südlicher|sudlicher|suedlicher
südliches|sudliches|suedliches
südost|so|sudost|suedost
südosten|sudosten|suedosten
südöstlich|sudostlich|suedoestlich
südöstliche|sudostliche|suedoestliche
südöstlicher|sudostlicher|suedoestlicher
südöstliches|sudostliches|suedoestliches
südwest|sw|sudwest|suedwest
südwesten|sudwesten|suedwesten
südwestlich|sudwestlich|suedwestlich
südwestliche|sudwestliche|suedwestliche
südwestlicher|sudwestlicher|suedwestlicher
südwestliches|sudwestliches|suedwestliches
west|w
westen
westlich|westl
westliche
westlicher
westliches