árok|arok
dűlő|dulo|d.|d
fasor
fasora
főközlekedési út|főút|fout
határút|hatarut
kapu
kert
körönd|korond|krnd
körvasútsor|korvasutsor
körút|korut|krt
köz|koz
lakótelep|lakotelep|ltp.|ltp
lejtő|lejto
lépcső|lepcso
liget
mező|mezo
országút|orszagut
park
parkja
rakpart|rkpt|rkp|rpt
sétány|setany|stny.|stny
sor|s.|s
sétány|setany|sét
sugárút|sugarut|sgrt.|sgrt|srt.|srt|sgt.|sgt
sziget
telep
tér|ter
tere
tanya|t.|t
udvar
utca|u.|u
út|ut|u.|u
útja|utja
