abbey|abby
access|accs
acres
alley|aly|ally|alee
alleyway|alwy|allyway|allwy
amble|ambl
annex|anx
apartments|apts|appartments
approach|app|apch
arcade|arc
arterial|artl
artery|art|arty
avenue|av|ave|aven|avenu|avn|avnu|avnue
avenues|avs|aves|avens|avenus|avns|avnus|avnues
autoroute|aut
back|bk
bank|bnk
basin|basn|bsn
bay
bayou|byu|bayoo
beach|baech|bch|beech
belt|blt
bend|bnd
block|blk|blck
bluff|blf|bluf|bluffs
boardwalk|bwk|bwlk|board walk
boulevard|bd|bde|blv|blvd|blvde|blvrd|boulavard|boul|boulv|bvd|boulevarde
bottom|bot|bottm|btm|bttm
bottoms|bttms|btms|bottms
boundary|bdy
bowl|bl
brace|br|brce
branch|br|brnch|brch
brae|br
break|brk
bridge|bdge|br|brdg|bri|brg
broadway|bdwy|bway|bwy|brdway
brook|brk
brow|brw
burg|bg
bypass|bypa|byps|bps|byp
byway|bywy
camp|cp
canyon|cyn|cnyn
caravan|cvan|cvn|c van
causeway|csway|cswy|causewy|caus|cause|cway
center|centre|cetr|cntr|ctr|c
centreway|cnwy
chase|ch
circle|cir|circel
circlet|clt
circuit|crct|circ|cct|cirt|ci|circt
circus|crcs|crc
claim|clm
cliff|clf
cliffs|clfs
close|cl|cls|clse
cluster|clr|clstr
colonnade|clde|clnde
common|cmmn|comm|cmn
commons|cmmns|cmns|comms
concord|cncd|cncrd
concession|conc
concourse|con|concs|concse|cnc
connection|cntn|cxn
connector|conr|cnctr|cntr
copse|cps
corner|cnr|crn|cor
corners|cnrs|crns|cors
corseo|cseo
corso|cso
country road|cr
course|crse
court|ct|crt
courts|crts|cts
courtyard|cyd|ctyd
cove|cov|ce|cv
crescent|cr|cres|crs|crecent
crest|crst|cst
crief|crf
croft|cft
cross|cs|crss
crossing|crsg|xing|csg
crossroad|crd|cross road|xroad|xrd
crossway|cowy|crwy|xway|xwy
cruiseway|cuwy|crwy
cul
cul de sac|cul-de-sac|culdesac|cds|cusac|csac
curve|cve|crv|crve
cutting|cttg|ctg|cutt
dale|dle
dell
deviation|devn
dip
distributor|dstr
divide|div
diversion|divers
down|dn
downs|dn|dns|dwns
drive|dr|drv|dv|dve
driveway|drwy|dvwy|dwy|dway|drvwy
drove|drov
easement|esmt
edge|edg
elbow|elb
elm
end
entrance|ent
esplanade|esp
estate|est
estates|ests
expressway|exp|expwy|expy
extension|ex|ext|extn|exten
fairway|fawy
fall|fl
falls|fls
fare
farm|frm
farms|frms
fern
ferry|fry
field|fld
fields|flds
fireline|fline|fire line|flne
firetrack|ftrk|fire track
firetrail|fitr|fire trail
flat|fl|flt
flats|flts
ferry|fy
field|fd
follow|folw
footway|ftwy|foot way
ford|frd
foreshore|fshr|fore shore
formation|form|fmtn
fort|ft
freeway|frwy|fw|fwy|fway
front|frnt
frontage|frtg|fr
gap
garden|gdn|grd|grdn
gardens|gdns|grds|grdns
gate|ga|gte
gates|gtes
gateway|gwy|gway
glade|gld|glde
glen|gln
grange|gra
green|grn|gn
ground|grnd
grounds|grnds
grove|gr|grv|grve|gro
gully|gly
hanger|hngr
harbor|harbour|hbr|hrbr
haven|hvn
head|hd
heads|hds
heath|hth
heights|hghts|hgts|hieghts|ht|hts|hgths
highlands|hghlds|hlds|hglds
highroad|hrd|high road|hird
highway|hgwy|hw|hway|hwy|hi|hwye|hwyw
hill|hl
hills|hls
hollow|hllw
hub
impasse|imp
inlet|inlt
interchange|intg|intchg|inter change
intersection|intn|inter section|intsctn
interstate|inter state|i
island|is|id|i
islands|iss|ids
junction|jct|jnc|jnct|jctn|jtn|junct|j
key|ky
keys|kys
knob
knoll|knol
knolls|knls
ladder|ladr
lagoon|lagn|lgn|lagon
landing|ldg|lndg|landng
lane|ln|la
laneway|lnwy
light|lgt|lt
limits|lmts
line
link|lnk|lk
little|lit|ltl|lt
lookout|lkt|look out
loop|lp
loops|lps
lower|low|lwr|lr
lynne|lynn
mall|ml
manor|mnr
maze
meadow|mdw
meadows|mdws
mead|md
meander|mndr|mdr|mr
mew|mw
mews|mws
mile|mi
mill|ml
mills|mls
middle|mid
moor
motorway|mway|mwy|mtwy
motu
mount|mt
mountain|mtn
mountains|mtns
neaves|nvs
nook|nk
oaks
outlet|otlt
outlook|out|otlk
oval
overbridge|ovrb|over bridge
paddock|padk
paku
palms|plms
parade|pde|prd|prde
park|pk|prk|parc
parklands|pkld|pklds|parkland|park lands|park land
parkway|pkwy|parkwy|pky|pkway|prkwy|prkway|pkw|pwy
part|prt
pass|ps
passage|psge|pass
path|pth
pathway|phwy|pway|pthway|pthwy|ptway|ptwy
peninsula|psla
ph pors
piazza|piaz|pzza
pike|pk
pine|pne|pn
pines|pns|pnes
place|pl|pla
plain|pln|pl
plains|plns|pls
plateau|plat|plt
plaza|plz|plza|pz
pocket|pkt|pokt|pckt
point|piont|pnt|pt
pointe|pte|pnte
port|pt|prt
prairie|pr
priors|prrs
private|pvt
promenade|prom|prm
quad|qd
quadrangle|qdgl
quadrant|qdrt|qd
quay|quy|qy
quays|quys|qys
radial|radl
ramble|ra|rmbl
ramp|rmp
ranae|ran
ranch|rnch
rapid|rpd
rapids|rpds
range|rng|rnge|rang
reach|rch
reef
reserve|res|resrv|resv|rsrv|rserv|rserve|rsrve
rest|rst
retreat|rt|rtt
return|rtn
ride
ridge|rdge|rdg
ridgeway|rgwy|rdgwy|ridge way
right of way|rowy|rightofway|rofw|row|r o w
ring
rise|ri
river|r|riv|rvr
riverway|rvwy
riviera|rvra
road|raod|rd
roads|raods|rds
roadside|rdsd|road side
roadway|rdwy|rdw
rocks|rks
rosebowl|rsbl|rose bowl
rotary|rty
round|rnd
route|rt|rte
row|rw
run
serviceway|swy|svwy|svcwy
shoal|shl
shoals|shls
shore|shor|shr
shores|shors|shrs
shunt|shun|shnt
siding|sdng|sdg
slope|slpe|slp
sound|snd
space|spc
spring|spg|sprng
springs|spgs|sprngs
spur|spr
square|sq|sqr
stairway|stwy|strwy|stair way|st wy|str way
state highway|shwy|sh|s hwy|s h|statehighway
state route|sr|stateroute|s r|s route|statert|s rt|state rt|st rt
strand|stra|strnd|strd
strands|strnds|strds
stravenue|stra|strav
street|st|str
strip|strp
subdivision|subdiv
subway|sbwy
summit|smt|sumt
tarn|tn
terrace|tce|ter|terr|terace|terrac|terrasse|tsse
thicket|thick
thoroughfare|thor|throughfare|thorough fare|thfr
thoroughway|thwy
throughway|thru
tollway|tlwy|twy
top
tor
tower|twr
towers|twrs
townline|tline
trace|trce
track|trk|trak
trafficway|trfy
trail|tr|trl
trailer|trlr
tram
tramway|tmwy
trees|trs
triangle|tri
trunkway|tkwy
tunnel|tun|tunl
turnabout|trnabt
turn|tn|trn
turnpike|tpk|tpke
underpass|upas|ups|under pass
union|un
upper|up|upr|uppr
vale|va|vl
valley|vlly|vy
via
viaduct|via|viad|vdct|viadct
view|vw
views|vws
villa|vll
villas|vlls
village|vil|vge|vill|villag|villg|vlg|vlge|vllg|vl
villages|vlgs
vista|vst|vsta|vis
vue
wade
walk|wlk|wk
walkway|wkwy|wky
waters|wtrs
way|wy
ways|wys
well|wl
wells|wls
wharf|whrf
whenua|whna
wood|wd
woods|wds
wynd|wyn
yard|yd|yrd