αδελφοί|αφοί|αδελφοί|αδελφοι|αφοι
adelfoí|adelfoi
αδελφών|αφών|αδελφων|αφων
adelfón|adelfon
εθνική|εθνικη|εθν
ethnikí|ethniki|ethn
εθνικής|εθνικης|εθν
ethnikís|ethnikis|ethn
εθνάρχου|εθναρχου|εθν
ethnárchou|ethnarchou|ethn
ελευθερίου|ελευθεριου|ελ
eleftheríou|eleftheriou|el
ελευθέριος|ελευθεριος|ελ
elefthérios|eleftherior|el
λίμνη|λιμνη|λ
límni|limni|l
νέα|νεα|ν
néa|nea|n
νέες|νεες|ν
nées|nees|n
νέα|νεα|ν
néa|nea|n
νέο|νεο|ν
néo|neo|n
νέοι|νεοι|ν
néoi|neoi|n
νησί|νησι|ν
όρος|ορος|όρ|ορ
óros|oros|ór|or
παλαιά|παλαια
palaiá|palaia|p
παλαιές|παλαιες
palaiés|palaies|p
παλαιό|παλαιο
palaió|palaio|p
παλαιοί|παλαιοι
palaioí|palaioi|p
παλαιός|παλαιος
palaiós|palaios|p
ποταμός|ποταμος|π|ποτ
potamós|potamos|p|pot