brothers|bros
cape|cpe|cp
city|cty
creek|cr|crk
county|co|cty
downs|downes|dwns
flats|flts
forest|frst|fst
fort|ft
fords|frds
fork|frk
forks|frks
forge|frg
forges|frgs
glens|glns
great|grt|gt
greater|grtr|gtr
greens|grns
groves|grvs
heights|hghts|hgts|hieghts|ht|hts|hgths
international|intl|int'l
lake|lk
lakes|lks
little|ltl|lttl|littl|litl
lock|lck
locks|lcks
lower|low|lwr|lr
medical|med
memorial|mem
middle|mid|midl
military|mil
mount|mt|mnt
mountain|mtn
mountains|mtns
municipal|mun|mpal
national|natl|nat'l
neck|nck
orchard|orch
paradise|pde|pdse
port|pt|prt
park|pk|prk
rear of|r / o|r o
river|riv|rvr|rivr
slope|slpe|slp
springs|spgs|sprngs
stream|strm|stm
triangle|tri
upper|up|upr|uppr
village|vlg|vlge|vilg|vilge
ville|vl
villages|vlgs
wood|wd
woods|wds