allotment
antenna|ant
apartment|apt|ap|aprt|aptmnt
barbecue|bbq|barbeque
berth|brth
boatshed|btsd
building|bdg|bldg|blg
block|blk|bl|blck
bungalow|bnglw|bongalow|bunglow|bungalo|bngw
cage
caravan|cvan
carpark|carp
carspace|cars
club
coolroom
cottage|cott|cottg
door
duplex|dup|dupl
extension|ext|extn
factory|fcty|fty|fy
farm|frm
flat|flt
garage|grge
hall
hangar|hngr
house|hse|hous|hs|ho
kiosk|ksk
lease|lse
lobby|lby|lbby
location|loc|locn|loctn
lot
maisonette|msnt
marine berth|mb|mbth
office|ofc|off|o|offc
parcel
penthouse|pths|ph|pent house
pier
portion|por
rear
reserve|rsve|rsrv|rsv|resv
room|rm
section|sec
shed|shd
shop|shp
showroom|shrm
sign
site
slip
space|spc
stall|stl|stll|sl
station
stop
store|stor
strata unit|su|str
studio|stu
substation|subs
suite|ste|se
tenancy|tncy
tower|twr
townhouse|tnhs|twnhs|tnhse|twnhse
trailer|trlr
trailer park lot|trlr park lot|trlr pk lot
unit|un|unt|u
van
vault|vlt
villa|vlla|vl
ward|wrd|wd
warehouse|we|whs|wrhs
workshop|wshp|wkshp|wksp
